x-------------------------------------x x-------------------------------------x
| This round:                         | | This game:                          |
| Deck:         ?? Cards              | | Round:          ??                  |
| Sideboard:    ?? Cards              | | Victory Tokens: ??                  |
| First Player: ???????????????????   | | Current Leader: ??????????????????? |
x-------------------------------------x x-------------------------------------x

x-------------------------------------x x-------------------------------------x
| Deck:                               | | Sideboard:                          |
|     ???????????????????????????  ?? | |     ???????????????????????????  ?? |
|     ???????????????????????????  ?? | |     ???????????????????????????  ?? |
|     ???????????????????????????  ?? | |     ???????????????????????????  ?? |
|     ???????????????????????????  ?? | |     ???????????????????????????  ?? |
|     ???????????????????????????  ?? | |     ???????????????????????????  ?? |
|     ???????????????????????????  ?? | |     ???????????????????????????  ?? |
|     ???????????????????????????  ?? | |     ???????????????????????????  ?? |
|     ???????????????????????????  ?? | |     ???????????????????????????  ?? |
|     ???????????????????????????  ?? | |     ???????????????????????????  ?? |
|     ???????????????????????????  ?? | |     ???????????????????????????  ?? |
|     ???????????????????????????  ?? | |     ???????????????????????????  ?? |
|     ???????????????????????????  ?? | |     ???????????????????????????  ?? |
|     ???????????????????????????  ?? | |     ???????????????????????????  ?? |
|     ???????????????????????????  ?? | |     ???????????????????????????  ?? |
|     ???????????????????????????  ?? | |     ???????????????????????????  ?? |
|     ???????????????????????????  ?? | |     ???????????????????????????  ?? |
|     ???????????????????????????  ?? | |     ???????????????????????????  ?? |
|     ???????????????????????????  ?? | |     ???????????????????????????  ?? |
|     ???????????????????????????  ?? | |     ???????????????????????????  ?? |
|     ???????????????????????????  ?? | |     ???????????????????????????  ?? |
x-------------------------------------x x-------------------------------------x

x-------------------------------------x x-------------------------------------x
| Player: ???????????????????         | | Player: ???????????????????         |
| Victory Tokens: ??                  | | Victory Tokens: ??                  |
| Hand:                               | | Hand:                               |
|     ???????????????????????????  ?? | |     ???????????????????????????  ?? |
|     ???????????????????????????  ?? | |     ???????????????????????????  ?? |
| Cards Played:                       | | Cards Played:                       |
|     ???????????????????????????  ?? | |     ???????????????????????????  ?? |
|     ???????????????????????????  ?? | |     ???????????????????????????  ?? |
|     ???????????????????????????  ?? | |     ???????????????????????????  ?? |
|     ???????????????????????????  ?? | |     ???????????????????????????  ?? |
|     ???????????????????????????  ?? | |     ???????????????????????????  ?? |
|     ???????????????????????????  ?? | |     ???????????????????????????  ?? |
|     ???????????????????????????  ?? | |     ???????????????????????????  ?? |
|     ???????????????????????????  ?? | |     ???????????????????????????  ?? |
|     ???????????????????????????  ?? | |     ???????????????????????????  ?? |
|     ???????????????????????????  ?? | |     ???????????????????????????  ?? |
x-------------------------------------x x-------------------------------------x
x-------------------------------------x x-------------------------------------x
| Player: ???????????????????         | | Player: ???????????????????         |
| Victory Tokens: ??                  | | Victory Tokens: ??                  |
| Hand:                               | | Hand:                               |
|     ???????????????????????????  ?? | |     ???????????????????????????  ?? |
|     ???????????????????????????  ?? | |     ???????????????????????????  ?? |
| Cards Played:                       | | Cards Played:                       |
|     ???????????????????????????  ?? | |     ???????????????????????????  ?? |
|     ???????????????????????????  ?? | |     ???????????????????????????  ?? |
|     ???????????????????????????  ?? | |     ???????????????????????????  ?? |
|     ???????????????????????????  ?? | |     ???????????????????????????  ?? |
|     ???????????????????????????  ?? | |     ???????????????????????????  ?? |
|     ???????????????????????????  ?? | |     ???????????????????????????  ?? |
|     ???????????????????????????  ?? | |     ???????????????????????????  ?? |
|     ???????????????????????????  ?? | |     ???????????????????????????  ?? |
|     ???????????????????????????  ?? | |     ???????????????????????????  ?? |
|     ???????????????????????????  ?? | |     ???????????????????????????  ?? |
x-------------------------------------x x-------------------------------------x